0000000000
0000990000
0009999000
0099999900
0999999990
9999559999
0000000000
0000000000
0000000000
0000000000
0000000000
