7000000000
7700000000
7770000000
7777000000
7777700000
0777770000
0077777000
0007777700
0000777770
0000077777
0000007777
